00000000000000000000
00000000000000000000
00000000000000000000
00000000000000666666
00000000000000666666
00000100000000666666
00000000000000000000
00000000030000000000
00000000000000000000
00000000044450000000
00000000000050000000
00000000000050000000
00000000000050000000
00000000000050000000
00000000000050000000
00000000000000000000
00002000000000030000
00000000000000000000
00000000000000000000
00000000000000000000